11111111
10000001
10111001
10001001
10001001
10111001
10000001
11111111
